#####################################################################################################################################################################################
#####################################################################################################################################################################################
##                                                                                                                                                                                 ##
##                                                                                                                                                                                 ##
##                                                                                                                                                     +                           ##
##                                                                                                   ######################                #######################                 ##
##                            #########                                             #########                                                                                      ##
##                            #########                                             #########                                                                                      ##
##                            #########                                             #########                   +                           +                                      ##
## #######################################################################################################################################################                         ##
##                                                                                                                                                                                 ##
##                                                                                                                                                                ###################
##                                                                                                                                                                                 ##
##                                                     +                                                                                                 +                         ##
##                                                  #######                                           ##                                             #########                     ##
##                                                  #######                                           ##                                             #########                     ##
##                                +                 #######                                           ##                                             #########                     ##
##       ################       #############       ###############################################################################################################                ##
##                                                                                                                                                                                 ##
##                                                                                                                                                                                 ##
##                                                                                                                                                                                 ##
##                                                                                     +                                                          +                                ##
##                                          ############                                 ###########                                          ################                     ##
##                                                                                                                                                                                 ##
##                             +                                     +                                           +                                                                 ##
##          ###################################           ##########################                   #######################                                                     ##
##                                                                                                                                                               ##########        ##
##                                                                                                                                                                                 ##
##                                                                                                                          #############                                          ##
##                                                                                                                                                                                 ##
##                                +                                              +                                                                     +                           ##
##      ############################################      ##############      #########      ######################    ###############   ##############################    ##########
##      ############################################      ##############      #########      ######################    ############### % ##############################    	   ##
##      ############################################  %%  ##############  %%  #########  %%  ###################### %% ############### % ##############################            ##
##      #########  ::::::::::::::::::::::::::::::::::::::::::::::::::::::::::::::::::::::::::::::::::::::::::::::::::::::::::::::::::::::::::::::::::::::::  ##########            ##
#####################################################################################################################################################################################
#####################################################################################################################################################################################